1111111111111111111111111111
10010001000001P1000000100011
1E10001000001001111000000001
10001000000000000C0111110001
1111111111111111111111111111