1111111111111111111111111111
1CC1CCC1CCCCCCPCCCCCCC100011
1CCCCCCCC111CCCC1CCCCC100001
1CCCCC111CCC1111111CCC00C0C1 
1ECC1CCCCC1CCCCCCC1111100011
1111111111111111111111111111