1111111111111111111111111111
1CC1CCC1CC000CPCCCCCCC100011
1C00000CC111CCCC1000CC100001
1CCCCC111CCC1111111CCC00C0C1
1ECC1CCCCC1C0000CC1111100011
1111111111111111111111111111