1111111111111111111111111111
10010001000000P0000000100011
1100000001110001000001000001
1E10001000001111111000000001
10001000001000000C0111110001
1111111111111111111111111111