111111111
1E0000001
11000C001
1P0000001
111111111