1111111111111111111
11E100C0001111CC011
1C11CCC1CCCCC1PCC11
1CCCCCCCC1110CCCCC1
1CCCCC111CCC1111111
1C1CCCCC1CCCCCC0111
1111111111111111111