1111111111111111111111111
1000000000100000000000001
1000000001E01000000000001
1100000000110000000000001
1000000000000000000000001
1100000000000000000000001
1000000P000000000C0000001
1111111111111111111111111