1111111111111111111111111
1E0000C10001111CC01000C01
1C01CCC101CC1CCC1PC0C0101
1101111CC111CCC110CCCCC11
1C001C0C0C011CCC1111000C1
1C1CCC1CC1CCC011CCC001001
1111111111111111111111111