111111111111111111111111111111111111
100E00101P00C00001000000001000100C01
11100101000N01000N00000N000000000011
1010010C00100NC0001001001000C1000001
1010010C00100NC000100C0010N000000101
101NN00C100000100000C000100001000001
111111111111111111111111111111111111