1111111111111111
1P10000C01C000N1
1011111101111101
1010C000C0000C01
1010111111111101
1000C000C0000C01
1010111111111101
1000C000C0000CE1
1111111111111111