1111111111111111111111111111111111
1E0000000000N00C00000C000000000001
1010010100100000101001000000010101
101001001010101000100100N000010101
1P0000000C00C0000N00001000000010C1
1000000000010000010000000000001001
1000000001000001000000000000100001
1000000010000000000010000000000001
10N00000100000001000000N0000001001
100010000010000N000001000000000001
1000001000000000000000000000000001
1111111111111111111111111111111111